CCCCCCCCCCCCCCCCCCCCCCCCCCCCCCCCCCCCCCCCCCCCCCCCCCCCCCCCCCCCCCCCCCCCCCCCCCCCCCCCCCCCCCCCCCCCCCCCCCCCCCCCCCCCCCCCCCCCCCCCCCCCCCCCCCCCCCCCCCCCCCCCCCCCCCCCCCCCCCCCCCCCCCCCCCCCCCCCCCCCCCCCCCCCCCCCCCCCCCCCCCCCCCCC111111111111111
CCCCCCCCC000000CCCCCCCCCCCCCCCCCCCCCCCCCCCCCCCCCCCCCCCCCCCCCCCCCCCCCCCCCCCCCCCCCCCCCCCCCCCCCCCCCCCCCCCCCCCCCCCCCCCCCCCCCCCCCCCCCCCCCCCCCCCCCCCCCCCCCCCCCCCCCCCCCCCCCCCCCCCCCCCCCCCCCCCCCCCCCCCCCCCCCCCCCCCCCCCCC111111111111111
CCCCCCCCCCCCCCCCCCC000CCCCCCCCCCCCCC0000CCCCCCCCCCCCCCCCCCCCCCCCCCC000CCCCCCCCCCCCCC0000CCCCCCCCCCCCCCCCCCCCCCCCCCC000CCCCCCCCCCCCCC0000CCCCCCCCCCCCCCCCCCCCCCCCCCC000CCCCCCCCCCCCCC0000CCCCCCCCCCCCCC0CCCCCCCCC400144444441111
CCCCCCCC000CCCCCCCC000CCCCC00000CCCC0000CCCCCCCCCCCCCCCC000CCCCCCCC000CCCCC00000CCCC0000CCCCCCCCCCCCCCCC000CCCCCCCC000CCCCC00000CCCC0000CCCCCCCCCCCCCCCC000CCCCCCCC000CCCCC00000CCCC0000CCCCCCCCCCCCC00C000CCCCC411111111111111
CCCCCCCC000CCCCCCCCCCCCCCCC00000CCCCCCCCCCCCCCCCCCCCCCCC000CCCCCCCCCCCCCCCC000000C0CCCCCCCCCCCCCCCCCCCCC000CCCCCCCCCCCCCCCC00000CCCCCCCCCCCCCCCCCCCCCCCC000CCCCCCCCCCCCCCCC00000CCCCCCCCCCCCCCCCCCCCCC0C000CCCCC411111111111111
CCCCCCCCCCCCCCCCCCCCCC>CCCCCCCCCCCCCCCCCCCCCCCCCCCCCCCCCCCCCCCCCCCCCCCCCCCCCCCCC05055555CCC555>CCCCCCCCCCCCCCACCCCCCCCCCC555CCCC5>>5CCCCCCCCCCCCCCCCCCCCCCCCCCCCCCCCCCCCCCCCCCCCCCCCCCCCCCCC==CCCCCCCC0CCCCCCCCC411110000011111
CCCCCCCCCCCCCCCCCCCCCCCCCCCCCCCCCCCCCCCCCCCCCCCCCCCCCCCCCCCCCCCCCCCCCCCCCCCCCCCCCCCCCCCCCCCCCCCCCCCCCCCCCCCCCCCCCCCCCCCCCCCCCCCCCCCCCCCCCCCCCCCCCCCCCCCCCCCCCCCCCCCCCCCCCCCCCCCCCCCCCCCCCCC===CCCCCCCC0CCCCCCCCC411111111111111
CCCCCCCCCCCCCCCCCCCCCCCCCCCCCCCCCCCCCCCCCCCCCCCCCCCCCCCCC00CCCCCCCCCCCCCCCCCCCCCCCCCCCCCCCCCCCCCCCCCCCCCCCCCCCCCCCCCCCCCCCCCCCCCCCCCCCCCCCCCCCCCCCCCCCCCCCCCCCCCCCCCCCCCCCCCCCCCCCCCCCCCCC====CCCCCCCC0CCCCCCCCC411100000001111
CCCCCCCCCCCCCCCCCCCCCCCCCCCCCCCCCCCCCCCCCCCCCCCCCCCCCCCCC00CCCCCBCCCCCCCCCCCCCCCCCCCCCCCCCCCCCCCCCCCCCCCCCCCCCCCCCCCCCCCCCCCCCCCCCCCCCCCCCCCCCCCCCCCCCCCCCCCCCCCCCCCCCCCCCCCCCCCCCCCCCCCC=====CCCCCCCC0CCCC000CC411111111111111
CCCCCCCCCCCCCCCC>CCC5A5>5CCCCCCCCCCCCCCCCCCCCC83CCCCCCCCC83CCCCCCCCCCCCCCCCCC5A5CCCCCCCCCCCCCC0CCCCC5?CCCC>CC>CC>CCCCC5CCCCCCCCCC55CCCCCC=CC=CCCCCCCCCC==CC=CCCCCCC00CCC55>5CCCCCCCCCCCC======CCCCCCCC0CCCC020CC411100000001111
CC0CCCCCCCCCCCCCCCCCCCCCCCCCCCCCCCCCCC83CCCCCC@9CC0CCCCCC@9CCCCCCCCCCCCCCCCCCCCCCCCCCCCCCCCCCCCCCC0CCCCCCCCCCCCCCCCCCCCCCCCCCCCCCCCCCCCC==CC==CCCC0CCC===CC==CCCCCC00CCCCCCCCCCCCCCCCCC=======CCCC0CCC0CCC00000C411144444441111
C000CCCCCCCCCCCCC0CCCCCCCCCC83CCCCCCCC@9CCCCCC@9C000CCCCC@9CCCCCC0CCCCCCCCCCCCCCCCCCCCCCCCCCCCCCC000CCCCCCC0CCCCC0CCCCCCCCCCCCCCCCCCCCC===CC===CC000C====CC===CCC0C83CCCCCCCCCCCCCC83C========CCC000CC0CCC22022C41114444444000;
00000CCCCCC00000000CCC0000CC@9CCCCCCCC@900000C@9000000CCC@900000000CCCC000CCCCCCCCCCCCCCC0000CCC00000CCCCCC0000000000CC000CC000C000CCC====00====0000=====CC====0000@9CC000CCCC000CC@9=========CC00000C=CCC221220411144444440067
::::::::::::::::::::::0:::::::::::::::::0::::::::::000:::::::::::::::CC:::::::::::::::CCC::::::::000:::::::0::::::000:::::::000:000::::::::::::::::::::::CC:::::::::::::::::::000:::::::::::::::::::::::::::::::<<<<<<<<<<<<<<<
